0000000000000000000000000000000000000000000000000000000000000
0000000000000000000000000000000000000000000000000000000000000
0000000000000000000000000000000000000000000000000000000000000
0000000000000000000000000000000000000000000000000000000000000
0000000000000000000000000000000000000000000000000000000000000
0000000000000000000000000000000000000000000000000000000000000
0000000000000000000000000000000000000000000000000000000000000
0000000000000000000000000000000000000000000000000000000000000
0000000000000000000000000000000000000000000000000000000000000
00000000000000000000000000P0000000000000000000000000000000000
0000000000000000000000000020000000000000000000000000000000000
0000000000000000000000002110000000000000000000000000000000000
000000000000000000G000021110000000000000000000000000000000000
200000Z00G0002222222222111100G000000002000000M000000000000000
1111111111111111111111111111111111110011111111111111111111111