1000000000000000000000000000000000000000000000000000000000000000000000000000000000000000000000000000000000000000000000000000000000000000000000000000000000000000000000000000000000000000000000000000000000000000000000000000000000000000000000000000000000000000000000000000Z00000000000000000
1000000000000000000000000000000000000000000000000000000000000000000000000000000000000000000000000000000000000000000000000000000000000000000000000000000000000000000000000000000000000000000000000000000000000000000000000000000000000000000000000000000000000000000000000000000000000000000000
1000000000000000000000000000000000000000000000000000000000000000000000000000000000000000000000000000000000000000000000000000000000000000000000000000000000000000000000000000000000000000000000000000000000000000000000000000000000000000000000000000000000000000000000000000000000000000000000
1000000000000000000000000000000000000000000000000000000000000000000000000000000000000000000000000000000000000000000000000000000000000000000000000000000000000000000000000000000000000000000000000000000000000000000000000000000000000000000000000000000000000000000000000000000000000000000000
10000000000000000000000000000000000000000000000000000000000000000000000000000000000000000000000000000000000000000000000000000000000000000000000000000000000000000000000000000000000000000000000000000000000000000000000000000000000000000000000000000000000000000000000000000000000C000000FFFFF
10000000000000000000000000000000000000000000000000000000000000000000000000000000000000000000000000000000000000000000000000000000000000000000000000000000000000000000000000000000000000000000000000000000000000000000000000000000000000000000000000000000000000000000000000000000000220000022222
10000000000000000000000000000000000000000000000000000000000000000000000000000000000000000000000000000000000000000000000000000000000000000000000000000000000000000000000000000000000000000000000I0000000000000000000000000000000000000000000M000000000000000000000000000000000000000000000001111
1000000000000000000000000000000000000000000000000000000000000000000000000000000000000000000000000000000000000000000000000000000000000000000000000000000000000000000000000000000000000000000000020000000000000000000000000000000000000000000Y000000000000000000000000000G00000000000000000001111
1000000000000000000000000000000000000000000000000000000000000000000000000000000000000000000000000000000000000000000000000000000000000000000000000000000000000000000000000000000000000000000000000000000000000000000000000000000000000000000ZZ00000000000000000000000000200000000H00000000000111
100000000000000000000000000000000000000000000000000000000000000000000000000000000000000000000000000000000000000000000000000000000000000000000000000000000000000000000000000000000M0000000222220000000000000000000000000000000000000000000G0A0G0000000000000000000000000000000002220000000000011
100000000000000000000000000000000000000000000000000000000000000000000000000000000000000000000000000000000000000000000000000000C000000000000000000000000000000000000000000000FFFFFFFFFF00000000000000000000000000000000000000000000000FF222222222FF000000000000000330000000000020000000002200001
10P00000000000000000000000000000000000000000000000000000000000000000000000000000000000000000000000000000000000000000000000000022000000000000000000000000000000000000000000002222222222000000000000000000000000000000000000000000000FF2211111111122FF000000000000022000000000000000000000000000
1222200000000000000000000000000000000000000000000000000000000000000000000000000000000000000000000000000000000000I0000002000000000000000022000000000000000000000000000000000000000000000000000000000000000000000000000000000000000FF22111111111111122FF0000000000000000000000000000000000000000
11111220000000000000000000000000000000000000000000C0K0000000000000000GH000000000000000000000000000000000000000FFFFF000000000000000000000000000000020000000000000333FFF333000000000000000000000000000000000000000000000000000000FF221111111111111111122FF00000000000000000000000000000000000C00
111111122000000000000000000V00000000000000000G0000222000000000000000222220000000000000000000000000000000000002222222000000000000000000000000000000000000000200002222222220000000000000000000000000000000000000000000000V00000FF2211111110000011111111122FF000000000000000000000000000000000220
11111111122000000000000000000000000000000000220000000000000000000000000000000000000000000M0000000000000000000444444400000000000000000000000000000000000000000000444444444000000000000000000000000000000000000000000000000000F2211111111100CE01111111111122FF00S0000022220000000000000000000000
1111111111122000000000000T00FFFFFFFF0G0G000000000000FFF000000FFFF000000000000200000000G0FFFF0G00000000000000000S000000000000000000000000000000000000000FFFF0000000000000000000000000000000000000M00000000200020000000000FFFF21111100000000111111111111111122FFF0000000000000000000000000000000
11111111111112222222222222222222222222222220000222222222000002222500000M0000612225000222222222200022222000G0000Z00G0000G00020000000000000000000000622222222222222222222222222200G00M000G002222233333322221000122210002222222111110000000011111111111111111112222200000000000000000000000000000
1111111111111111111111111111111111111111111333311111111100000111111FFFFFFFF1111115000111111111000111111222222222222222222221150000000000000000000611111111111111111111111111112222222222221111111111111111000111111000111111111000011111111111111111111111111111100000000000000000000000000220
1111111111111111111111111111111111111111111111111111111100000111111111111111111115000000000000001111111111111111111111111111500000000000000000000061111111111111111111111111111111111111111111111111111111000111111100001111110000111111111111111111111111111111100000000000000000000000000000
11111111111111111111111111111111111111111111111111111111000001111111111111111111150000000C0000011111111111111111111111111111150000000000000000000611111111111111111111111111111111111111111111111111111111000111111100000000000011111111111111111111111111111111100000000000000000F00000000000
1111111111111111111111111111111111111111111111111111111100000111111111111111111115333111111111111111111111111111111111111111500000000000000000000061111111111111111111111111111111111111111111111111111111000111111113311111111111111111111111111111111111111111100000000000000000200000I00E003
11111111111111101111111111111111111111111111111111111111000001111111111111111111111111111111111111111111111111111111111111111500000000000000000006111111111111111111111111111111111111111111111111111111110001111111111111111111111111111111111111111111111111111200000000000000000000002002002