0000000000000000000000000000000000000000000000000000000000000
0000000000000000000000000000000000000000000000000000000000000
0000000000000000000000000000000000000000000000000000000000000
0000000000000000000000000000000000000000000000000000000000000
0000000000000000000000000000000000000000000000000000000000000
0000000000000000000000000000000000000000000000000000000000000
0000000000000000000000000000000000000000000000000000000000000
0000000000000000000000000000000000000000000000000000000000000
0000000000000000000000000000000000000000000000000000000000000
0000000000000000000000000000000000000000000000000000000000000
0000000000000000000000000020000000000000000000000000000000000
0000000000000000000000002110000P00000000000000000000000000000
0000000000000000000000021110000000000000000000000000000000000
200000Z00000022222222221111000000000002000000M000000000000000
1111111111111111111111111111111111110011111111111111111111111