0000000000000000000000000000000000000000000000000000000000000
0000000000000000000000000000000000000000000000000000000000000
0000000000000000000000000000000000000000000000000000000000000
0000000000000000000000000000000000000000000000000000000000000
0000000000000000000000000000000000000000000000000000000000000
0000000000000000000000000000000000000000000000000000000000000
0000000000000000000000000000000000000000000000000000000000000
0000000000000000000000000000000000000000000000000000000000000
0000000000000000000000000000000000000000000000000000000000000
00000000000000000C0000000000000000000000000000000000000000000
00000000000000002220000000P0000000000000000000000000000000000
00000000000000000000000021100000H00000000H0000000000000000000
00000Z0000000000H0SS00021115001000000000000000000M00000000000
2FFFFFFFFD0G0222222222211115CW100G33002FFFFFFFFFFFFFF00G00000
1111111111111111111111111111111111110011111111111111111111111