111111111111111111111111111111111111111111111111111111111111111111111111
100000000000000000000000000000000000000000000000000000000000000000000001
100000000000000000000000000000000000000000000000000000000000000000000001
100000000000000000000000000000000000000000000000000000000000000000000001
100000000000000000000000000000000000000000000000000000000000000000000001
100000000000000000000000000000000000000000000000000000000000000000000001
100000000000000000000000000000000000000000000000000000000000000000000001
100000000000000000000000000000000000000000000000000000000000000000000001
100000000000000000000000000000000000000000000000000000000000000000000001
100000000000000000000000000000000000000000000000000000000000000000000001
100000000000000000000000000000000000000000000000000000000000000000000001
100000000000000000000000000000000000000000000000000000000000000000000001
100000000000000000000000000000000000000000000000000000000000000000000001
100000000000000000000000000000000000000000000000000000000000000000000001
100000000000000000000000000000000000000000000000000000000000000000000001
100000000000000000000000000022222222222222200000000000000000000000000001
100000000000000000000000000000000000000000000000000000000000000000000001
100000000000000000000000000000000000000000000000000000000000000000000001
100000000000000000000000000000000000000000000000000000000000000000000001
100000000000000000000000000000000000000000000000000000000000000000000001
100000000000000000000000000000000000000000000000000000000000000000000001
100000000000000000000000000000000000000000000000000000000000000000000001
100000000000000000000000000000000000000000000000000000000000000000000001
100000000000000000000000000000000000000000000000000000000000000000000001
100000000000000000000000000000000000000000000000000000000000000000000001
100000000000000000000000000000000000000000000000000000000000000000000001
100000000000000000000000000000000000000000000000000000000000000000000001
100000000000000000000000000000000000000000000000000000000000000000000001
100000000000000000000000000000000000000000000000000000000000000000000001
100000000000000000000000000000000000000000000000000000000000000000000001
100000000000000000000000000000000000000000000000000000000000000000000001
100000000000000000000000000000000022222222222000000000000000000000000001
10000000000000000P000000000000000000000000000000000000000000000000000001
100000000002222222222220000000000000000000000000000000000000000000000001
100000000001111111111110000000000000000000000000000000000000000000000001
100000000001111111111110002222222222220000000000000000000000000000000001
100000000001111111111110000000000000000000000000000000000000000000000001
100000000001111111111110000000000000000022222222222220000000000000000001
100000000001111111111110000000000000000011111111111110000000000000000001
100000000001111111111110000000000000000000000000000000000000000000000001
100000000001111111111110000000000000000000000000000000000000000000000001
100111000001111111111110000000000000000000000000000000000000000000000001
100000000001111111111112222222200000000000000000000000000000000000000001
111111111111111111111111111111111111111111111111111111111100000000011111
111111111111111111111111111111111111111111111111111111111100000000011111