1111111111111111111000000000000000000000000000000000000000000000000000000000000
1111111111111111111000000000000000000000000000000000000000000000000000000000000
1111111111111111111000000000000000000000000000000000000000000000000000000000000
1111111111111111111000000000000000000000000000000000000000000000000000000000000
1111111111111111111000000000000000000000000000000000000000000000000000000000000
1111111111111111111000000000000000000000000000000000000000000000000000000000000
1111111111111111111000000000000000000000000000000000000000000000000000000000000
1111111111111111111000000022222222000000000000000000000000000000000000000000000
1111111111111111111000000000000000000000000000000000000000000000000000000000000
1111111111111111111000000000000000000000000000000000000000000000000000000000000
1111111111111111111000000000000000000000000000000000000000000000000000000000000
1111111111111111111000022222222200000000000000000000000000000000000000000000000
1111111111111111111000000000000000000000000000000000000000000000000000000000000
1111111111111111111000000000000000022222222200000000000000000000000000000000000
1111111111111111111000000000000000000000000000000000000000000000000000000000000
1111111111111111111000000022222222000000000000000000000000000000000000000000000
1111111111111111111000000000000000000000000000000000000000000000000000000000000
1111111111111111111000000000000000000000000000000000000000000000000000000000000
1111111111111111111220000000000000000000000000000000000000000000000000000000000
1111111111111111111112222222222222222000000000000222222222222222220000000011200
1111111111111111111111111111111111111200000000002111111111111111111100001111100
1111111111111111111111111111111111111100000000021111111111111111111100001111100
1111111111111111111111111111111111111100000000211111111111111111111100001111100
1111111111111111111111111111111111111100000002111111111111111111111100001111100
1111111111111111111111111111111111111122222221111111111111111111111111111111111