0000000000000000000000000000000000000000000000000000000000000
0000000000000000000000000000000000000000000000000000000000000
0000000000000000000000000000000000000000000000000000000000000
0000000000000000000000000000000000000000000000000000000000000
0000000000000000000000000000000000000000000000000000000000000
0000000000000000000000000000000000000000000000000000000000000
0000000000000000000000000000000000000000000000000000000000000
0000000000000000000000000000000000000000000000000000000000000
0000000000000000000000000000000000000000000000000000000000000
000000000000000000000H000000000000000000000000000000000000000
00000000000000000000000000P0001000000000000000000000000000000
00000000000000000220000021100010H0000000000000000000000000000
0000000000000000H0SSH0021110001000000000000000000000000000000
200000Z00D0G02222222222111100W100G00002000000M000G00000G00000
1111111111111111111111111111111111110011111111111111111111111