0000000000000000000000000000000000000000000000000000000000000077777777777777777777777777777777777777777777777777777777777777
0000000000000000000000000000000000000000000000000000000000000077777777777777777777777777777777777777777777777777777777777777
0000000000000000000000000000000000000000000000000000000000000077777777777777777777777777777777777777777777777777777777777777
0000000000000000000000000000000000000000000000000000000000000077777777777777777777777777777777777777777777777777777777777777
0000000000000000000000000000000000000000000000000000000000000077777777777777777777777777777777777777777777777777777777777777
0000000000000000000000000000000000000000000000000000000000000077777777777777777777777777777777777777777777777777777777777777
0000000000000000000000000000000000000000000000000000000000000077777777777777777777777777777777777777777777777777777777777777
0000000000000000000000000000000000000000000000000000000000000077777777777777777777777777777777777777777777777777777777777777
0000000000000000000000000000000000000000000000000000000000000077777777777777777777777777777777777777777777777777777777777777
0000000000000000000000000000000000000000000000000000000000000077777777777777777777777777777777777777777777777777777777777777
0000000000000000000000000000000000000000000000000000000000000077777777777777777777777777777777777777777777777777777777777777
0000000000000000000000000000000000000000000000000000000000000077777777777777777777777777777777777777777777777777777777777777
0000000000000000000000000000000000000000000000000000000000000077777777777777777777777777777777777777777777777777777777777777
0000000000000000000000000000000000000000000000000000000000000077777777777777777777777777777777777777777777777777777777777777
0000000000000000000000000000000000000000000000000000000000000077777777777777777777777777777777777777777777777777777777777777
0P00000000000000000000000000000000000000000000000000000000000077777777777777777777777777777777777777777777777777777777777777
7777777777777777777777777777777777777777777777777777777777777777777777777777777777777777777777777777777777777777777777777777
7777777777777777777777777777777777777777777777777777777777777777777777777777777777777777777777777777777777777777777777777777
7777777777777777777777777777777777777777777777777777777777777777777777777777777777777777777777777777777777777777777777777777
7777777777777777777777777777777777777777777777777777777777777777777777777777777777777777777777777777777777777777777777777777