00000000000000000000000000000000000000000000000000000000000000
00000000000000000000000000000000000000000000000000000000000000
00000000000000000000000000000000000000000000000000000000000000
00000000000000000000000000000000000000000000000000000000000000
00000000000000000000000000000000000000000000000000000000000000
00000000000000000000000000000000000000000000000000000000000000
00000000000000000000001110000000000000000000000000000000000000
00000000000000000000000010000000000000000000000000000000000000
00000000000000000000000110000000000000000000000000000000000000
00000000000000000000000010000000000000000000000000000000000000
00000000000000000000001110000000000000000000000000000000000000
00000000000000000000000000000000000000000000000000000000000000
00000000000000000000000000000000000000000000000000000000000000
0000000000000000P00000000L000000000000000000000000000000000000
11111111111111111111111111111111111111111111111111111111111111