0000000000000000000000000000000000000000000000000000000000000000000000000000000000000000000000000000000000000000000000000000000000000000000
0000000000000000000000000000000000000000000000000000000000000000000000000000000000000000000000000000000000000000000000000000000000000000000
7777777777777777777777777777777777777777777777777777777777777777777777777777700000000000007777777777777777777777777777777777777777777777777
7777777777777777777777777777777777777777777777777777777777777777777777777777700000000000007777777777777777777777777777777777777777777777777
777700RRR7777777777777777777777777777777777777777777777777777777777777777777700000000000007777777777777777777000000000000000000000000000077
7777U0RRR77777777777777777777777777777777777777777777777777777777777777777777000000000000000000000000000000000000000000000000000000000000OL
777777RRR777777777777700000000000000000000000000000000000000077777777777777770000000000000000000000000000000000000000FFFFFFFFFFFFFFFF00000L
7000000000000077777777000000X0000000000000000Z0000000000000000000077700000077000000000000000000000FFFFFFFFFFFFF7777777777777777777777777777
70000000Q0000077777777000777777777770000FFFFFFFFFF00007777700000000000000000000000000007777777777777777777777777777777777777777777777777777
7FFFFFFFFFFFFF7777777700077777777777777777777777777777777770000000000000000J000000000000007777777777777777777777777777777777777777777777777
777777777777RRRRR0I0E0000777777777777777777777777777777777777777000077000000000000000000007777777777777777777777777777777777777777777777777
777777777777RRRRRFFFFFFFFF77777770000000000000007777777777777777733333333377700000000000007777777777777777777777777777777777777777777777777
77777777777777777777777777777777000000000QI000077777777777777777777777777777700000000000007777777777777777777777777777777777777777777777777
777777777777777777777777777777770000FFFFFFFFFFF77777777777777777777777777777700000000000007777777777777777777777777777777777777777777777777
7777777777777777777777777777777700077777777777777777777777777777777777777777700000000007777777777777777777777777777777777777777777777000777
7777777777777777777777777777777700077777777777777777777777777777777777777777700000000000004444444444444444444444444444444444444444477000777
777777777777777777777777777777770007777777777777777777777777777777777777777770000000000000000900000000009000000000H900000000009000000000777
777777777777700000000000000000000000000000000000000000000000000000000000000000000000000000000000000000FFFFFF000000Z000FFFFFFF00000077700777
7777777777700000090000000000900000000009000000000090000000000900000000009000000000000007777777777777777777777777777777777777777777777000777
7777777770000000000000000000000000000000000000000000000000000000000000000000000000000000007777777777777777777777777777777777777777777000777
7777777000000077777777777777777777777777777777777777777777777777777777777777777700000000007777777777777777777777777777777777777777777000777
7000000000007777777777777777777777777777777777777777777777777777777777777777700000000000007777777777777777777777777777777777777777777000777
7000000030777777777777777777777777777777777777777777777777777777777777777777700000000000007777777777777777777777777777777777777777777000777
700PSKW07777777777777777777777777777777777777777777777777777777777777777777770000000000000777777777777777777777777777FFFFF00000000000000777
777777777777777777777777777777777777777777777777777777777777777777777777777FF0000000000000777777777777777777F00000000000000000090000B000777
77777777777777777777777777777777777777777777777777777777777777770007777FFFFFF000000000000077777777777777777F000000009000Q000000000000000777
77777777777777777777777777777777777777777777777777777777777777770E0FFFFFFFFFF000000000007777777777FFFFFFFFF00000000000000000777777777777777
7777777777777777777777777777777777777777777777777777777777777777777777777777700000000000000000000000000000000000077777777777777777777777777
7777777777777777777777777777777777777777777777777777777777777777777777777777700000000000000000900000000009000007777777777777777777777777777
7777777777777777777777777777777777777777777777777777777777777777777777777777700000077700000000000000000000000077777777777777777777777777777
7777777777777777777777777777777777777777777777777777777777777777777777777777700000000000007777777777777777777777777777777777777777777777777
7777777777777777777777777777777777777777777777777777777777777777777777777777700000000000007777777777777777777777777777777777777777777777777
7777777777777777777777777777777777777777777777777777777777777777777777777777700000000000007777777777777777777777777777777777777777777777777
