0000000000000000000000000000000000000000000000000000000000000000000000000000000000000000000000000
0000000000000000000000000000000000000000000000000000000000000000000000000000000000000000000000000
7777777777777777777777777777777777777777777777777777777777777777777777777777777777777777777777777
7777777777777777777777777777777777777777777777777777777777777777777777777777777777777777777777777
7777700Y0000000000000000000000000000000000000000000000000000000000000000000000000000000000007000L
77777000000900000900000900000900000000000000000Q00000000000000000090000090000090000090000000O000L
777770IEI0000M000000M00000000000000000FFFFF000000000000000000000000000000Z0000000Z0000+000000000L
7777777777777777777777777777777770077777777700000000000000000077777777777777777777777777777777777
7777777777777770000000077777777770077777700000000000000000000077777777777777777777777777777777777
77777777777777700000000777777777700777777000000000M0000000000077777777777777777777777777777777777
7777777777777770770000074444444470077777700000777777777000000077777777777777777777777777777777777
7777777777777770750000000000000000067777700000000000000000000677777777777777777777777777777777777
7777777777777770750900000000009000067777700000000000000000000677777777777777777777777777777777777
777777777777777075000M000Z000M0000067777700000000000090M00900677777777777777777777777777777777777
7777777777777770777777777777777777777777700000000000FFFFFFFF0077777777777777777777777777777777777
7777777777777770777770000000000000000007700000000000777777770077777777777777777777777777777777777
7777777777777770777770009000000000090007700000000000000000000077777777777777777777777777777777777
7777770000000000677770000000000000000000000000000000000000000077777777777777777777777777777777777
7777770000000000677770777777777777777777700000000000000000000000000000000000RRRRRRRRRRRRRRRR77777
7777700900000090677770777777777777777777770007700000000000000000000000090009RRRRRRRRRRRRRRRR77777
777770Q0000000006777707777777777777777777500000000000000000000FFFFFFFFF00X00RRRRRRRRRRRRRRRR77777
7777707777777777777770777777777777777777750000000000MM0000000777777777777777777777777777777R77777
77777077777777777777707777777777777777777500000FFFFFFFFFFF000077777777777777777777777777777R77777
7777700000000000000000777777777777777777750Q00077777777777000077777777777777777777777777777R77777
7777700000000000000000000777777777777700000000000000000000000077777777777777777777777777777R77777
7777700000000000000000000000000000000000000000000000000000000077777777777777777777777777777R77777
77777000000Z0Z0Z0Z0000U007777777777777N000-000000000000000000077777777777777777777777777777R77777
7777777777777777777777777777777777777777777700000000000000000077777777777777777777777777777R77777
7777777777777777777777777777777777777777700000000000000000000077777777777777777777777777777R77777
7777777777777777777777777777777777777777700000000000000000000077777777777777777777777777777R77777
7777777777777777777777777777777777777777700000000000077770000077777777777777777777777777777R77777
7000000000000000000000000000000000000000000000000000000000000077777777777777777777777777777R77777
70000900000900000900000900000900000900000000000000000000000Q00777777777777777777777777H0H0H077777
7000P000000000000000000000000000000000000000000333000000000000777777777777777777777777IIIII077777
77777777777777777777777777777777777777777000077777770000000000777777777777777777777777IIIII077777
7777777777777777777777777777777777777777700000000000000000000077777777777777777777777777777777777
7777777777777777777777777777777777777777700000000000000000000077777777777777777777777777777777777