00000000000000000000000000000000000000000000000000000000000000
00000000000000000000000000000000000000000000000000000000000000
00000000000000000000000000000000000000000000000000000000000000
00000000000000000000000000000000000000000000000000000000000000
00000000000000000000000000000000000000000000000000000000000000
00000000000000000000000000000000000000000000000000000000000000
00000000000000000000000000000000000000000000000000000000000000
00000000000000000000000000000000000000000000000000000000000000
00000000000000000000000000000000000000000000000000000000000000
00000000000000000000000000001000100000000000000000000000000000
00000000000000000000000000000101000000000000000000000000000000
00000000000000000000000000000010000000000000000000000000000000
00000000000000000000000000000000000000000000000000000000000000
0000000000000000P0000000000L0000000000000000000000000000000000
11111111111111111111111111111111111111111111111111111111111111