00000000000000000000000000000000000000000000000000000000000000000000000000000000000000000000000000000000000000000000000000000000000000000000000000000000000000
00000000000000000000000000000000000000000000000000000000000000000000000000000000000000000000000000000000000000000000000000000000000000000000000000000000000000
00000000000000000000000000000000000000000000000000000000000000000000000000000000000000000000000000000000000000000000000000000000000000000000000000000000000000
000000000000000000000000000000000000000000000000000000000000000000000000J0000000000000000000000000000000000000000000000000000000000000000000000000000000000000
00000000000000000000000000000000000000000000000000000000000000000000000000000000000000000000000000000000000000000000000000000000000000000000000000000000000000
0000000000000000000000000000000000000000000000J000000000000000000000000000000000000000000000000000000000000000000000000000000000000000000000000000000000000000
00000000000000000000000000000000000000000000000000000000000000000000000000000000000000000000000000000000000000000000000000000000000000000000000000000000000000
00000000000000000000000000000000000000000000000000777770077777000000000000000000000000000000000000000000000000000000000000000000000000000000000000000000000000
00000000000000000000000000000000000000000000000000000070070000000000000000000000000000000000000000000000000000000000000000000000000000000000000000000000000000
00000000000000000000000000000000000000000000000000000070070000000000000000000000000000000000000000000000000000000000000000000000000000000000000000000000000000
00000000000000000000000000000000000000000000000000000070070000000000000000000000000000000000000000000000000000000000000000000000000000000000000000000000000000
00000000000000000000000000000000000000000000000000000070070000000000000000000000000000000000000000000000000000000000000000000000000000000000000000000000000000
00000000000000000000000000000000000000000000000000000070070000000000000000000000000000000000000000000000000000000000000000000000000000000000000000000000000000
00000000000000000000000000000000000000000000000000000070070000000000000000000000000000000000000000000000000000000000000000000000000000000000000000000000000000
00000000000000000000000000000000000000000000000000000070070000000000000000000000000000000000000000000000000000000000000000000000000000000000000000000000000000
00000000000000000000000000000000000000000000000000000070070000000000000000000000000000000000000000000000000000000000000000000000000000000000000000000000000000
00000000000000000000000000000000000000000000000000000070070000000000000000000000000000000000000000000000000000000000000000000000000000000000000000000000000000
00000000000000000000000000000J00000000000000000000000070070000000000000000000000000000000000000000000000000000000000000000000000000000000000000000000000000000
00000000000000000000000000000000000000000000000000000070070000000000000000000000000000000000000000000000000000000000000000000000000000000000000000000000000000
0000000000000000000000000000000000000070000000000000+070070000000000000000000000000000000022000000000000000000000000000000000000000000000000000000000000000000
00000000000000000000000000000000000000000000000000007770070000000000000000000000000000000011000000000000000000000000000000000000000000000000000000000000000000
00000000000000000000000000700000000000000000000000000070070000000000000000000000000000000011000000000000000000000000000000000000000000000000000000000011111111
11000000000000000000000000000000000000000000000000000070070000000003000000000000000000002211000000000000000000000000000000000000000000000000000000000010000000L
11100000000000000000000000000000000000000000000000000070070000000061000000000000000000001111000000000000000000000000000000000000000000000000000000000010000000L
11110000000000000000000000000070000000000000000000000070070000000061000000000000000000001111000000000000000000000000000000000000000000000000000000000010000000L
11110000000000000000000000000070000000000000000000000070070000000061000000000000000000221111000000000000000000000000000000000000000000000000000000000010011111
11110000000000000000000000000070000000000000000000000000000000000061000000000000000000111111000000000000000000000000000000000000000000000000000000000010011111
11110000000000000000000000000070000000000000000000000000000000000061000000000000000000111111000000000000000000000J0000000000000000000000J000000000000010011111
777100000000000000000000000000700000000000000000000000000000000000610000000000000000221111110000000000000000000000000M0000000000000000000000000000000010011111
777700000000000000000000000700700000000000000000000000077000000000610000000000000000111111110000000000000000000000000E000000000000000E+00000000000000010011111
77770000000000000000000000000070000000000000000000000000000000000061000000000000000011111111000000002200000000000222222222000000000002200000000000000010011111
77770000000000000000000000000070000000000000000000000000000000000061000000000H00002211111111000000000000000000000000000000000000000000000000000000000010011111
O00000000000000000000000000000700000000000000000000000000000000000610000000E0E0E001111111111000000000000000000000000000000000000000000000000000000000000011111
000P000000000000000000770000007000000000000000000000000000000000006100X000000000001111111111000Z000M00Z0000Z00M00Z0002Z0000Z00000M000Z000000M00000009000011111
777722222222222222220000000000000000000000000000000000000000000000612222222222222211111111112222222222222222222222222122222222222222222222222222222222222221111
777711111111111111113333333333333333333333333333333333333333333333311111111111111111111111111111111111111111111111111111111111111111111111111111111111111111111
777711111111111111111111111111111111111111111111111111111111111111111111111111111111111111111111111111111111111111111111111111111111111111111111111111111111111