00000000000000000000000000000000000000000000000000000000000000000000000000000000000000000000000000000000000000000000000000000000000000000000000000000000000000
00000000000000000000000000000000000000000000000000000000000000000000000000000000000000000000000000000000000000000000000000000000000000000000000000000000000000
00000000000000000000000000000000000000000000000000000000000000000000000000000000000000000000000000000000000000000000000000000000000000000000000000000000000000
000000000000000000000000000000000000000000000000000000000000000000000000J0000000000000000000000000000000000000000000000000000000000000000000000000000000000000
00000000000000000000000000000000000000000000000000000000000000000000000000000000000000000000000000000000000000000000000000000000000000000000000000000000000000
0000000000000000000000000000000000000000000000J000000000000000000000000000000000000000000000000000000000000000000000000000000000000000000000000000000000000000
00000000000000000000000000000000000000000000000000000000000000000000000000000000000000000000000000000000000000000000000000000000000000000000000000000000000000
00000000000000000000000000000000000000000000000000777770077777000000000000000000000000000000000000000000000000000000000000000000000000000000000000000000000000
00000000000000000000000000000000000000000000000000000070070000000000000000000000000000000000000000000000000000000000000000000000000000000000000000000000000000
00000000000000000000000000000000000000000000000000000070070000000000000000000000000000000000000000000000000000000000000000000000000000000000000000000000000000
00000000000000000000000000000000000000000000000000000070070000000000000000000000000000000000000000000000000000000000000000000000000000000000000000000000000000
00000000000000000000000000000000000000000000000000000070070000000000000000000000000000000000000000000000000000000000000000000000000000000000000000000000000000
00000000000000000000000000000000000000000000000000000070070000000000000000000000000000000000000000000000000000000000000000000000000000000000000000000000000000
00000000000000000000000000000000000000000000000000000070070000000000000000000000000000000000000000000000000000000000000000000000000000000000000000000000000000
00000000000000000000000000000000000000000000000000000070070000000000000000000000000000000000000000000000000000000000000000000000000000000000000000000000000000
00000000000000000000000000000000000000000000000000000070070000000000000000000000000000000000000000000000000000000000000000000000000000000000000000000000000000
00000000000000000000000000000000000000000000000000000070070000000000000000000000000000000000000000000000000000000000000000000000000000000000000000000000000000
00000000000000000000000000000J00000000000000000000000070070000000000000000000000000000000000000000000000000000000000000000000000000000000000000000000000000000
000000000000000000000000000000000000000000000000000000700700000000000000000000000000000000C0000000000000000000000000000000000000000000000000000000000000000000
0000000000000000000000000000000000000070000000000000+070070000000000000000000000000000000022000000000000000000000000000000000000000000000000000000000000022222
00000000000000000000000000000000000000000000000000007770070000000000000000000000000000000011000000000000000000000000000000000000000000000000000000000002211111
0000000000000000000000000070000000000000000000000000007007000000000000000000000000000000FF11000000000000000000000000000000000000000000000000000000000221111111
11000000000000000000000000000000000000000000000000000070070000000003000000000000000000002211000000000000000000000000000000000000000000000000000000000110000000L
11100000000000000000000000000000000000000000000000000070070000000061000000000000000000001111000000000000000000000000000000000000000000000000000000000110000000L
11110000000000000000000000000070000000000000000000000070070000000061000000000000000000FF1111000000000000000000000000000000000000000000000000000000000110000000L
11110000000000000000000000000070000000000000000000000070070000000061000000000000000000221111000000000000000000000000000000000000000000000000000000000110011111
11110000000000000000000000000070000000000000000000000000000000000061000000000000000000111111000000000000000000000000000000000000000000000000000000000110011111
111100000000000000000000000000700000000000000000000000000000000000610000000000000000FF111111000000000000000000000J0000000000000000000000J000000000000110011111
777100000000000000000000000000700000000000000000000000000000000000610000000000000000221111110000000000000000000000000M0000000000000000000000000000000110011111
777700000000000000000000000700700000000000000000000000077000000000610000000000000000111111110000000000000000000000330E033000000000000E+00000000000000110011111
7777000000000000000000000000007000000000000000000000000000000000006100000000000000FF11111111000000002200000000000222222222000000000002200000000000000110011111
77770000000000000000000000000070000000000000000000000000000000000061000000000H00002211111111000000000000000000000000000000000000000000000000000000000110011111
O00000000000000000000000000000700000000000000000000000000000000000610000000E0E0E0011111111110000000M0Z00000Z00000000000000000000000000000000000000000000011111
0P0000G0FFFFFFFFF0G000770000007000000000000000000000000000000000006100X0FFFFFFFF001111111111000Z0G0FFFF0G0FFF0M0GZ0002Z00G0Z00G00M000Z00G000M000G0000000011111
777722222222222222220000000000000000000000000000000000000000000000612222222222222211111111112222222222222222222222222122222222222222222222222222222222222111111
777711111111111111113333333333333333333333333333333333333333333333311111111111111111111111111111111111111111111111111111111111111111111111111111111111111111111
777711111111111111111111111111111111111111111111111111111111111111111111111111111111111111111111111111111111111111111111111111111111111111111111111111111111111
